##################################################
##################################################
.............##.................................##
.............#.......||||||||||||...............##
.............####.......||||||.||||||||||.......##
................#.......|||||||||||||||||.......##
#########.||....#.........||||||................##
##......#..|....#..........|||||||||........|...##
##......#..|....###.........||||||||........||..##
##......#..||||...#........||||||||||||......|..##
##.######....|....#........||||||||||||......|..##
##.#.........||...####.....|.....|||||||.....||.##
##.#.................#.....||..|||||||||||....|.##
##.#.................#......|||......|||......|.##
##.#......|..........###......|...|||||||.......##
##.##.....||...........#......|....|||||||......##
##..######||...........#......|||....||||.......##
##.......#|||||........####.....||...||||||.....##
##.|.....#....|.........####.....||......||.....##
##||.....##...|||...........##..........||||....##
##||||....###...|...........###............||...##
##..|||....##...||............#..........|||....##
##.||||||..####...............####........||||..##
##..|||||.....#..................#........||.|..##
##.||||||||...###................####......|.|||##
##.|||||||||....#..............||...###....||.|.##
##.......||||...#####...........|.....#.....||..##
##....||||||||......###.........||....#####..||.##
##.....||||||||.....####.........|||||....####..##
##.......||||||||......####..........||....###..##
##........||||||||||......#####..............##.##
##...........||||||||.........##..............####
##..............|||||..........######............>
##..............|||||||.............####.........>
##.................|||||||...........###.........>
##################################################
##################################################
