##################################################
##################################################
................................................##
................................................##
...............................###..............##
...................||||......########.....||||..##
############.......||.|.....##...|..##...||||...##
##.........##......||||||..##....||..#...||||...##
##......#####........||||..######.|..##....|||..##
##.#######............||||......#.||..##....||..##
##.#.........|||.......|||......##.||..#..|||...##
##.#.........||||......|||.......##.|..#..||....##
##.#..........||||.....|||........#.||.#.|||....##
##.#..........|||||...............#....#.|||....##
##.#..........||||||.............##...##.||.....##
##.############.||.|...........###....#..||.....##
##...||||||...#.||||........####.....##..||.....##
##..||||||||..#..||........##........#...|......##
##.||.........#..||........#...||||..#...||#....##
##.|###########...||.......#....||...#..||###...##
##||.#.............|.......##...|....#..|.#.##..##
##||.#......................##.||....#....#..#..##
##...#.......|||.............##.|.####....#..#..##
##...#........||||............#.|##.......#..#..##
##...#.........|||............#||#.......#...#..##
##...#...........||........####|.##.....##...#..##
##.|.############|||....#######|..#######....#..##
##.|...........##..||...#......|.............#..##
##.||||||......##..||...##.||...............##..##
##.||||....#####...|||...#.||..##############...##
##.|||..#####......||||..#.|..##|||||||||||.....##
##..||..##................#...#|||||||||||......##
##..|||..#................#...#||||||||||.......##
##..|||..###################..############......##
##...||..##.........................######......##
##########################################>>>>>>##
##########################################>>>>>>##